NO textures/walls/blue_stone.xpm
SO textures/walls/color_stone.xpm
WE textures/walls/red_brick.xpm
EA textures/walls/eagle.xpm

F                   184,113,39
C 51,198,227

         111111111  111111111111111111
         100000001  100000000000000001
         10110000111100000001111111111
11111111110000000000000000011111
10000000111100010000W00001001
100000001  10011010111000000111111111
10000000111110000001 1010000000000001
11111111111111111111 1111111111111111
     
1111 111111111111111111111111
1111 1000000cococococ00000001
1111 111111111111111111111111

