NO textures/walls/blue_stone.xpm
SO              textures/walls/color_stone.xpm
WE textures/walls/red_brick.xpm
EA                                 textures/walls/eagle.xpm

F         184,113,39
C                                   51,198,227

1111111111
100000000111111111111111111
101000000000000000000000001
100000000111111111111111111
1000000001
100000E001
1111111111