NO textures/walls/blue_stone.xpm
SO textures/walls/color_stone.xpm
WE textures/walls/red_brick.xpm
EA textures/walls/wood.xpm

F 220,     100,0
C 225,30,     0

111111111111111111111111
1000000000110000000000001
1011000001110000000000001
10010000000000000000000011111111
111111111011000001110000000000001
100000000011000001110111110111111
11110111111111011100000010001
11110111111111011101010010001
11000000110101011100000010001
1000000000000000110000001p001
10000000000000001101010010001
11000001110101011111011110N0111
11110111 1110101 101111010001
11111111 1111111 111111101111
