NO textures/walls/grey_stone.xpm
SO textures/walls/red_brick.xpm
WE textures/walls/color_stone.xpm
EA textures/walls/blue_stone.xpm

C 53,41,34
F 45,33,27

111111111111111
111111000111111
111110000011111
1111000N0001111
111000000000111
110000000000011111111
100001111100000000001
110000111000011111111
111000010000111
111100000001111
111110000011111
111111000111111
111111111111111

