        111111111  111111111111111111
         100000001  100000000000000001
         10110000111100000001111111111
11111111110000000000000000011111
10000000111100010000000001001
100000001  100110101110000001
10000000111110000001 10000001
11111111111111111111 11011111
                      101
1111 111111111111111111011111
1111 1000000cococococ00N00001
1111 111111111111111111111111