1111111111
1000000001
11111S1111
1000000001
1111111111