1111111111
1000000001
11111N1111
1000000001
1111111111